NO ./textures/gray_64.xpm
SO ./textures/mossy_64.xpm


F 0,255,0

WE ./textures/brown_64.xpm
EA ./textures/brick_64.xpm





C 0,0,255

111111111
100000001
100111001
100000001
1000N0001
100000001
111111111
