NO ./path_to_the_north_texture
SO ./path_to_the_south_texture


F 220,100,0

WE ./path_to_the_west_texture
EA ./path_to_the_east_texture





C 225,30,0

11P111111
100000001
100111001
100000001
1000N0001
100000001
11111111111111
