111111111
100000001
100111001
100000001
1000N0001
100000001
111111111