11111111
10100001
10100001
1000P001
11111111