111   11111
101   00001
101000    01
1000   P001
1 1 1 1 1 1 1 1