
NO ./textures/redbrick_32.xpm
SO ./textures/redbrick_32.xpm
WE ./textures/brick_64.xpm
EA ./textures/brick_64.xpm

F 0,255,0
C 0,255,255

        1111111111111111111111111
        1000000000110000000000001
        1011000001110000000000001     11111
        1001000000000000000000001     10001
111111111011000001110000000000001     11111
100000000011000001110111111111111
111111111111111111111111111111111

11111111111111111111111111111
11110111111111011100000010001
11110111111111011101010010001
11000000110101011100000010001
10000000000000001100000010001
10000000000000001101010010001
11000001110101011111011110N01
11110111 1110101 101111010101
11111111 1111111 111111110001
11111111111111111111111111111
