1111111011111
1000000000001
1011111111101
101       101
101       101
101 11111 101
101 10001 101
101 10001 101
101 100011101
101 100000001
101 100001001
111 111111111

