11111111
10100001
10100-01
1000N001
11111111